                 -`
                .o+`
               `ooo/
              `+oooo:
             `+oooooo:
             -+oooooo+:
           `/:-:++oooo+:
          `/++++/+++++++:
         `/++++++++++++++:
        `/+++ooooooooooooo/`
       ./ooosssso++osssssso+`
      .oossssso-````/ossssss+`
     -osssssso.      :ssssssso.
    :osssssss/        osssso+++.
   /ossssssss/        +ssssooo/-
 `/ossssso+/:-        -:/+osssso+-
`+sso+:-`                 `.-/+oso:
`++:.                           `-/+/
`.`                                 `/
### System Overview ###
OS: Arch Linux
Kernel: 6.17.7-arch1-1
Uptime: up 58 minutes
Shell: /usr/bin/bash
Packages (pacman): 1374
WM/DE: i3
Terminal: xterm-kitty
CPU: Intel(R) Core(TM) i9-14900HX
GPU(s): Intel Corporation Raptor Lake-S UHD Graphics (rev 04) NVIDIA Corporation AD107M [GeForce RTX 4060 Max-Q / Mobile] (rev a1)


### Explicitly Installed Official Packages (pacman) ###
a2ps - An Any to PostScript filter
acpi - Client for battery, power, and thermal readings
acpid - A daemon for delivering ACPI power management events with netlink support
adobe-source-code-pro-fonts - Monospaced font family for user interface and coding environments
adobe-source-sans-fonts - Sans-serif font family for user interface environments
adobe-source-serif-fonts - Serif typeface designed to complement Source Sans
alsa-firmware - Firmware binaries for loader programs in alsa-tools and hotplug firmware loader
alsa-utils - Advanced Linux Sound Architecture - Utilities
arandr - Provide a simple visual front end for XRandR 1.2.
archlinux-xdg-menu - automatic generate WM menu from xdg files
arch-wiki-docs - Pages from Arch Wiki optimized for offline browsing
ardour - Professional-grade digital audio workstation
base - Minimal package set to define a basic Arch Linux installation
base-devel - Basic tools to build Arch Linux packages
code - The Open Source build of Visual Studio Code (vscode) editor
copyq - Clipboard manager with searchable and editable history
cpupower - Linux kernel tool to examine and tune power saving related features of your processor
cups - OpenPrinting CUPS - daemon package
cups-pdf - PDF printer for cups
ddcutil - Query and change Linux monitor settings using DDC/CI and USB.
discord - All-in-one voice and text chat for gamers
dmidecode - Desktop Management Interface table related utilities
docker - Pack, ship and run any application as a lightweight container
docker-compose - Fast, isolated development environments using Docker
dolphin - KDE File Manager
dunst - Customizable and lightweight notification-daemon
efibootmgr - Linux user-space application to modify the EFI Boot Manager
exfat-utils - Utilities for exFAT file system
fastfetch - A feature-rich and performance oriented neofetch like system information tool
feh - Fast and light imlib2-based image viewer
firefox - Fast, Private & Safe Web Browser
flameshot - Powerful yet simple to use screenshot software
font-manager - A simple font management application for GTK+ Desktop Environments
gdm - Display manager and login screen
git - the fast distributed version control system
gnuplot - Plotting package which outputs to X11, PostScript, PNG, GIF, and others
gobject-introspection - Introspection system for GObject-based libraries
grub - GNU GRand Unified Bootloader (2)
gucharmap - Unicode Character Map
helvum - GTK patchbay for PipeWire
htop - Interactive process viewer
hunspell-en_us - US English hunspell dictionaries
i3status - Generates status bar to use with i3bar, dzen2 or xmobar
i3-wm - Improved dynamic tiling window manager
imv - Image viewer for Wayland and X11
inotify-tools - inotify-tools is a C library and a set of command-line programs for Linux providing a simple interface to inotify.
intel-ucode - Microcode update files for Intel CPUs
inxi - Full featured CLI system information tool
jack-example-tools - Official JACK example clients and tools
jq - Command-line JSON processor
juce - Cross-platform C++ framework
kde-cli-tools - Tools based on KDE Frameworks to better interact with the system
kdeconnect - Adds communication between KDE and your smartphone
kdenlive - A non-linear video editor for Linux using the MLT video framework
kdialog - A utility for displaying dialog boxes from shell scripts
kitty - A modern, hackable, featureful, OpenGL-based terminal emulator
less - A terminal based program for viewing text files
lib32-nvidia-utils - NVIDIA drivers utilities (32-bit)
libdvdcss - Portable abstraction library for DVD decryption
libmythes - a simple thesaurus
libreoffice-fresh - LibreOffice branch which contains new features and program enhancements
libreoffice-fresh-pt-br - Portuguese (Brasil) language pack for LibreOffice Fresh
libva-nvidia-driver - VA-API implementation that uses NVDEC as a backend
libva-utils - Intel VA-API Media Applications and Scripts for libva
linux - The Linux kernel and modules
linux-firmware - Firmware files for Linux - Default set
linux-headers - Headers and scripts for building modules for the Linux kernel
loupe - A simple image viewer for GNOME
ltrace - Tracks runtime library calls in dynamically linked programs
mesa-utils - Essential Mesa utilities
musescore - Create, play and print beautiful sheet music
mythes-en - English thesaurus
nano - Pico editor clone with enhancements
networkmanager - Network connection manager and user applications
network-manager-applet - Applet for managing network connections
noto-fonts - Google Noto TTF fonts
npm - JavaScript package manager
nss-mdns - glibc plugin providing host name resolution via mDNS
numlockx - Turns on the numlock key in X11.
nvidia-container-toolkit - NVIDIA container toolkit
nvidia-dkms - NVIDIA kernel modules - module sources
nvidia-prime - NVIDIA Prime Render Offload configuration and utilities
nvtop - GPUs process monitoring for AMD, Intel and NVIDIA
obs-studio - Free, open source software for live streaming and recording
ollama-cuda - Create, run and share large language models (LLMs) with CUDA
os-prober - Utility to detect other OSes on a set of drives
pacman-contrib - Contributed scripts and tools for pacman systems
pavucontrol - PulseAudio Volume Control
picom - Lightweight compositor for X11
pipewire - Low-latency audio/video router and processor
polkit-gnome - Legacy polkit authentication agent for GNOME
polybar - A fast and easy-to-use status bar
pqiv - Powerful image viewer with minimal UI
pyenv - Easily switch between multiple versions of Python
python-httpx - A next generation HTTP client for Python
python-matplotlib - A python plotting library, making publication quality plots
python-osc - Open Sound Control server and client implementations in pure Python
python-pip - The PyPA recommended tool for installing Python packages
python-playwright - A Python library to automate Chromium, Firefox and WebKit browsers with a single API
python-virtualenv - Virtual Python Environment builder
qbittorrent - An advanced BitTorrent client programmed in C++, based on Qt toolkit and libtorrent-rasterbar
qpwgraph - PipeWire Graph Qt GUI Interface
qt5-3d - C++ and QML APIs for easy inclusion of 3D graphics
qt5-declarative - Classes for QML and JavaScript languages
qt5-graphicaleffects - Graphical effects for use with Qt Quick 2
qt5-imageformats - Plugins for additional image formats: TIFF, MNG, TGA, WBMP
qt5-location - Provides access to position, satellite and area monitoring classes
qt5-multimedia - Classes for audio, video, radio and camera functionality
qt5-networkauth - Network authentication module
qt5-quickcontrols - Reusable Qt Quick based UI controls to create classic desktop-style user interfaces
qt5-quickcontrols2 - Next generation user interface controls based on Qt Quick
qt5-script - Classes for making Qt applications scriptable. Provided for Qt 4.x compatibility
qt5-sensors - Provides access to sensor hardware and motion gesture recognition
qt5-serialport - Provides access to hardware and virtual serial ports
qt5-speech - Qt module to make text to speech and speech recognition easy
qt5-tools - A cross-platform application and UI framework (Development Tools, QtHelp)
qt5-virtualkeyboard - Virtual keyboard framework
qt5-wayland - Provides APIs for Wayland
qt5-xmlpatterns - Support for XPath, XQuery, XSLT and XML schema validation
qt6-3d - C++ and QML APIs for easy inclusion of 3D graphics
qt6-charts - Provides a set of easy to use chart components
qt6-connectivity - Provides access to Bluetooth hardware
qt6-datavis3d - Qt6 Data Visualization module
qt6-doc - A cross-platform application and UI framework (Documentation)
qt6-examples - Examples and demos from qt6 documentation
qt6-graphs - Qt Graphs for data visualization
qt6-grpc - Provides the modules QtGrpc and QtProtobuf
qt6-httpserver - Qt HTTP Server
qt6-imageformats - Plugins for additional image formats: TIFF, MNG, TGA, WBMP
qt6-languageserver - An implementation of the Language Server Protocol
qt6-location - Helps you create viable mapping solutions using the data available from some of the popular location services
qt6-lottie - A family of player software for a certain json-based file format for describing 2d vector graphics animations
qt6-networkauth - Network authentication module
qt6-positioning - Provides access to position, satellite and area monitoring classes
qt6-quick3d - Qt module and API for defining 3D content in Qt Quick
qt6-quick3dphysics - Physics engine integration for Qt Quick 3D
qt6-quickeffectmaker - Qt Quick Effect Maker (QQEM) for creating and editing custom shader effects
qt6-quicktimeline - Qt module for keyframe-based timeline construction
qt6-remoteobjects - Inter-process communication (IPC) module developed for Qt
qt6-scxml - Static and runtime integration of SCXML models into Qt6 code
qt6-sensors - Provides access to sensor hardware and motion gesture recognition
qt6-serialbus - Qt module for general purpose serial bus access
qt6-serialport - Provides access to hardware and virtual serial ports
qt6-tools - A cross-platform application and UI framework (Development Tools, QtHelp)
qt6-virtualkeyboard - Virtual keyboard framework
qt6-webchannel - Provides access to QObject or QML objects from HTML clients for seamless integration of Qt applications with HTML/JavaScript clients
qt6-webengine - Provides support for web applications using the Chromium browser project
qt6-websockets - Provides WebSocket communication compliant with RFC 6455
qt6-webview - Provides a way to display web content in a QML application
realtime-privileges - Realtime privileges for users
rofi - A window switcher, application launcher and dmenu replacement
rtcqs - Scanner for potential real-time bottlenecks
rtirq - Realtime IRQ thread system tuning.
rt-tests - A collection of latency testing tools for the linux(-rt) kernel
schedtool - Query or alter a process' scheduling policy
sox - The Swiss Army knife of sound processing tools
spotify-launcher - Client for spotify's apt repository in Rust for Arch Linux
sshfs - FUSE client based on the SSH File Transfer Protocol
strace - A diagnostic, debugging and instructional userspace tracer
sudo - Give certain users the ability to run some commands as root
syncthing - Open Source Continuous Replication / Cluster Synchronization Thing
timeshift - A system restore utility for Linux
ttf-caladea - A serif font family metric-compatible with Cambria font family
ttf-carlito - Google's Carlito font
ttf-dejavu - Font family based on the Bitstream Vera Fonts with a wider range of characters
ttf-liberation - Font family which aims at metric compatibility with Arial, Times New Roman, and Courier New
ttf-linux-libertine-g - Graphite port of Linux Libertine and Linux Biolinum fonts
ttf-nerd-fonts-symbols - High number of extra glyphs from popular 'iconic fonts'
ttf-ubuntu-font-family - Ubuntu font family
tuna - Thread and IRQ affinity setting GUI and cmd line tool
usbutils - A collection of USB tools to query connected USB devices
v4l2loopback-dkms - v4l2-loopback device – module sources
v4l2loopback-utils - v4l2-loopback device – utilities only
vlc - Free and open source cross-platform multimedia player and framework
vlc-plugins-all - Free and open source cross-platform multimedia player and framework - all plugins
vulkan-tools - Vulkan tools and utilities
wget - Network utility to retrieve files from the web
wine-gecko - Wine's built-in replacement for Microsoft's Internet Explorer
wine-mono - Wine's built-in replacement for Microsoft's .NET Framework
winetricks - Script to install various redistributable runtime libraries in Wine.
wmctrl - Control your EWMH compliant window manager from command line
woff2-font-awesome - Iconic font designed for Bootstrap - woff2 format
xdotool - Command-line X11 automation tool
xfce4-pulseaudio-plugin - Pulseaudio plugin for the Xfce4 panel
xorg-server - Xorg X server
xorg-xinit - X.Org initialisation program
xorg-xinput - Small commandline tool to configure devices
xorg-xwininfo - Command-line utility to print information about windows on an X server
xterm - X Terminal Emulator
yabridge - A modern and transparent way to use Windows VST2 and VST3 plugins on Linux
yabridgectl - Optional utility to help set up and manage yabridge
zenith - Terminal system monitor with histograms
zenity - Display graphical dialog boxes from shell scripts


### AUR Packages (installed via yay) ###
bitwig-studio - Digital audio workstation for music production, remixing and live performance
clipse - A configurable TUI clipboard manager for Unix.
ddcci-driver-linux-dkms-git - A pair of Linux kernel drivers for DDC/CI monitors (DKMS) - git version
gyroflow - Video stabilization using gyroscope data
hid-ite8291r3-dkms-git - Linux kernel driver for the ITE 8291 (rev 0.03) RGB keyboard backlight controller
hunspell-pt-br - Brazillian Portuguese grammar, spelling and hyphenation checker to hunspell
jre - Oracle Java Runtime Environment
laptop-mode-tools - Power saving tool for Linux
lib32-obs-vkcapture - OBS Linux Vulkan/OpenGL game capture (32-bit)
makemkv - DVD and Blu-ray to MKV converter
mkinitcpio-numlock - Enable numlock in early userspace
obs-vkcapture - OBS Linux Vulkan/OpenGL game capture
phonon-qt6-mpv - Phonon MPV backend for Qt6
plugdata-bin - Plugin wrapper around Pure Data with a new JUCE GUI, allowing patching in DAWs
python-diffusers - Pretrained diffusion models for image and audio generation in PyTorch
python-safetensors - Simple, safe way to store and distribute tensors
python-wordcloud - A little word cloud generator in Python
qt5-charts - Provides a set of easy to use chart components
qt5-connectivity - Provides access to Bluetooth hardware
qt5-datavis3d - Qt Data Visualization module
qt5-quick3d - Qt module and API for defining 3D content in Qt Quick
qt5-remoteobjects - Inter-process communication (IPC) module developed for Qt
qt5-scxml - Static and runtime integration of SCXML models into Qt code
qt5-webchannel - Provides access to QObject or QML objects from HTML clients for seamless integration of Qt applications with HTML/JavaScript clients
qt5-webengine - Provides support for web applications using the Chromium browser project
qt5-websockets - Provides WebSocket communication compliant with RFC 6455
rar - A command-line port of the rar compression utility.
realtime-generic-setup - Generic realtime setup configuration
rofi-mixer-git - A script that generates a rofi menu that uses bluetoothctl to connect to bluetooth devices and display status info
rtapp - Realtime application thread priority tuning
ttf-gentium-basic - Fonts based on the original Gentium design with additional weights
ttf-meslo-nerd-font-powerlevel10k - Meslo Nerd Font patched for Powerlevel10k
tuxedo-control-center-bin - A tool to help you control performance, energy, fan and comfort settings on TUXEDO laptops.
tuxedo-drivers-dkms - TUXEDO Computers kernel module drivers for keyboard, keyboard backlight & general hardware I/O using the SysFS interface
yay - Yet another yogurt. Pacman wrapper and AUR helper written in go.
yt6801-dkms - Kernel module for Motorcomm YT6801 ethernet controller (DKMS)
zoom - Video Conferencing and Web Conferencing Service
zotero - A free, easy-to-use tool to help you collect, organize, cite, and share your research sources.
zsh-theme-powerlevel10k-git - Powerlevel10k is a theme for Zsh. It emphasizes speed, flexibility and out-of-the-box experience.


